JEJEJEJEJEJEJEJEJEJEJ
E       M         M E
J J JMJMJ JMJMJMJ J J
E M M           M M E
JMJ J J JMJMJMJMJ J J
E   M M     M   M M E
J JMJMJMJMJ J J J J J
E         M M M   M E
J JMJ JMJMJ JMJMJMJ J
E M   M   M M   M   E
J JMJ J JMJ J J JMJ J
E   M   M     M   M E
JMJ JMJMJMJMJMJMJ J J
E     M       M   M E
J JMJ J JMJMJ J JMJ J
E   M   M   M   M   E
JMJ JMJMJ JMJMJMJMJ J
E       M     M     E
J J JMJMJMJ J J JMJMJ
E M         M       E
J JEJEJEJEJEJEJEJEJEJ
 F